1111111111
1C000C0001
1000000001
100011C001
1001001011
1P0011E0C1
1111111111