111111111111111111111111111111111111111111111111111111111111111111111111111111111111111
1C000C00000000000000000000001C000C000000000000000000000011C000C000000000000000000000011
100000000000000000000000000010000000000000000000000000001100000000000000000000000000011
100011C00C000000100000000000100011C00C0000001000000000001100011C00C00000010000000000011
1C000C00000000000000001110001C000C000000000000000011100011C000C000000000000000011100011
100000000000000000000011100010000000000000000000001110001100000000000000000000011100011
1C000C00000000000000001110001C000C000000000000000011100011C000C000000000000000011100011
100000000000000000000011100010000000000000000000001110001100000000000000000000011100011
1C000C00000000000000001110001C000C000000000000000011100011C000C000000000000000011100011
100000000000000000000000000010000000000000000000000000001100000000000000000000000000011
1C000C00000000000000000000001C000C000000000000000000000011C000C000000000000000000000011
100000000000000000000000000010000000000000000000000000001100000000000000000000000000011
1C000C00000000000000000000001C000C000000000000000000000011C000C000000000000000000000011
100000000000000000000000100010000000000000000000000010001100000000000000000000000100011
100000000000000000000000100010000000000000000000000010001100000000000000000000000100011
1C000C00000000000000000010001C000C000000000000000000100011C000C000000000000000000100011
100100101111000C000000001000100100101111000C0000000010001100100101111000C00000000100011
1P0011E0C0000000000000000000000001100C000000000000000000000001100C000000000000000000011
111111111111111111111111111111111111111111111111111111111111111111111111111111111111111