11111111111111111111111111111
1C000C00000000000000000000001
10000000000000000000000000001
100011C00C0000001000000000001
1C000C00000000000000001110001
10000000000000000000001110001
1C000C00000000000000001110001
10000000000000000000001110001
1C000C00000000000000001110001
10000000000000000000000000001
1C000C00000000000000000000001
10000000000000000000000000001
1C000C00000000000000000000001
10000000000000000000000010001
10000000000000000000000010001
1C000C00000000000000000010001
100100101111000C0000000010001
1P0011E0C00000000000000000001
11111111111111111111111111111