1111111
1000001
1001001
1001001
1P01001
1111111