1111111111
1000000001
1000010001
1000110001
1001001001
1P0011E001
1111111111