111111111111111111111111
1000000010000000000001E1
11010C00000000C000000001
100010001111111111111111
10100C00000000C000000001
101000000000000000000001
101000000000000011111111
1010000000000000100000C1
101000000111100010010001
1P1C000001C0001000010C01
111111111111111111111111